###############################
# ............................#
#.###############.#############
#.............................#
#.####.################.......#
#....#.#......................#
#....#.###########............#
#.............................#
###############################